000111101011110
000000000010100
011010110000001
000010111110000
011110010100100
010001100001101
000011110101100
001111100111111
001000001000011
001010001000100
001100100100110
001001001101000
010011000000100
010111100111110
000011110000000